
    ########     #
    #  # # ###$  #
    #### # ####  #
    #  ### #     #
    #    ######  #
    #########    #
  ###   #   ######
    #   #   #